10
40
........................................
........................................
S........III.................III........
##.......###.................###........
........................................
....III.......III.................III...
....###.......###................I###...
.................................#***...
.P.....................###....E.........
#######################***##############