10
40
........................................
........................................
.........III.................III........
.........###.................###........
........................................
....III.......III.................III...
....###.......###................I###...
.................................####...
.P.....................###....E.........
########################################