40
15
........................................
........................................
........................................
........................................
........................................
........................................
........................................
.........GGG.................GGG........
.........###.................###........
........................................
....GGG.......GGG.................GGG...
....###.......###................G###...
.................................####...
.1.....................###..............
########################################